Key	KEYWORD1
PS2Protocol	KEYWORD1
PS2Keyboard	KEYWORD1
PS2KeyboardManager	KEYWORD1
Report	KEYWORD1
begin	KEYWORD2
avialable	KEYWORD2
read	KEYWORD2
end	KEYWORD2
getLEDs	KEYWORD2
setErrorHandler	KEYWORD2
isShiftPressed	KEYWORD2
isControlPressed	KEYWORD2
isAltPressed	KEYWORD2
isGuiPressed	KEYWORD2
isKeyPressed	KEYWORD2
resetKeyboard	KEYWORD2
setTypematicRateAndDelay	KEYWORD2
setLEDs	KEYWORD2
write	KEYWORD2
writeAndWait	KEYWORD2
